level3
19 19
0 0 0 0 0 0 0 0 0 0 0 0 0 0 0 0 0 0 0
0 1 1 2 2 2 2 2 2 2 2 2 2 2 2 2 2 2 0
0 1 0 2 0 2 0 2 0 2 0 2 0 2 0 2 0 2 0
0 2 2 2 2 2 2 2 2 2 2 2 2 2 2 2 2 2 0
0 2 0 2 0 2 0 2 0 2 0 2 0 2 0 2 0 2 0
0 2 2 2 2 2 2 2 2 2 2 2 2 2 2 2 2 2 0
0 2 0 2 0 2 0 2 0 2 0 2 0 2 0 2 0 2 0
0 2 2 2 2 2 2 2 2 2 2 2 2 2 2 2 2 2 0
0 2 0 2 0 2 0 2 0 2 0 2 0 2 0 2 0 2 0
0 2 2 2 2 2 2 2 2 2 2 2 2 2 2 2 2 2 0
0 2 0 2 0 2 0 2 0 2 0 2 0 2 0 2 0 2 0
0 2 2 2 2 2 2 2 2 2 2 2 2 2 2 2 2 2 0
0 2 0 2 0 2 0 2 0 2 0 2 0 2 0 2 0 2 0
0 2 2 2 2 2 2 2 2 2 2 2 2 2 2 2 2 2 0
0 2 0 2 0 2 0 2 0 2 0 2 0 2 0 2 0 2 0
0 2 2 2 2 2 2 2 2 2 2 2 2 2 2 2 2 2 0
0 2 0 2 0 2 0 2 0 2 0 2 0 2 0 2 0 2 0
0 2 2 2 2 2 2 2 2 2 2 2 2 2 2 2 2 3 0
0 0 0 0 0 0 0 0 0 0 0 0 0 0 0 0 0 0 0